4
5
13101
10101
10101
10101
10021
5
10031
10111
10101
10101
12001
5
00013
01110
21000
01111
00000
5
30011
11011
10200
01110
00000